image = { 64, 8, 3,
  
    0,   0,   0,   0,   0,   0,   0,   0,   0,   0,   0,   0,   0,   0,   0,   0,   0,   0,   0,   0,   0,   0,   0,   0,   0,   0,   0,   0,   0,   0,   0,   0,   0,   0,   0,   0,   0,   0,   0,   0,   0,   0,   0,   0,   0,   0,   0,   0,   0,   0,   0,   0,   0,   0,   0,   0,   0,   0,   0,   0,   0,   0,   0,   0,   0,   0,   0,   0,   0,   0,   0,   0,   0,   0,   0,   0,   0,   0,   0,   0,   0,   0,   0,   0,   0,   0,   0,   0,   0,   0,   0,   0,   0,   0,   0,   0,   0,   0,   0,   0,   0,   0,   0,   0,   0,   0,   0,   0,   0,   0,   0,   0,   0,   0,   0,   0,   0,   0,   0,   0,   0,   0,   0,   0,   0,   0,   0,   0,   0,   0,   0,   0,   0,   0,   0,   0,   0,   0,   0,   0,   0,   0,   0,   0,   0,   0,   0,   0,   0,   0,   0,   0,   0,   0,   0,   0,   0,   0,   0,   0,   0,   0,   0,   0,   0,   0,   0,   0,   0,   0,   0,   0,   0,   0,   0,   0,   0,   0,   0,   0,   0,   0,   0,   0,   0,   0,   0,   0,   0,   0,   0,   0, 
    0,   0,   0,   0,   0,   0,   0,   0,   0,   0,   0,   0,   0,   0,   0,   0,   0,   0,   0,   0,   0,   0,   0,   0,   0,   0,   0,   0,   0,   0,   0,   0,   0,   0,   0,   0,   0,   0,   0,   0,   0,   0,   0,   0,   0,   0,   0,   0,   0,   0,   0,   0,   0,   0,   0,   0,   0,   0,   0,   0,   0,   0,   0,   0,   0,   0,   0,   0,   0,   0,   0,   0,   0,   0,   0,   0,   0,   0,   0,   0,   0,   0,   0,   0,   0,   0,   0,   0,   0,   0,   0,   0,   0,   0,   0,   0,   0,   0,   0,   0,   0,   0,   0,   0,   0,   0,   0,   0,   0,   0,   0,   0,   0,   0,   0,   0,   0,   0,   0,   0,   0,   0,   0,   0,   0,   0,   0,   0,   0,   0,   0,   0,   0,   0,   0,   0,   0,   0,   0,   0,   0,   0,   0,   0,   0,   0,   0,   0,   0,   0,   0,   0,   0,   0,   0,   0,   0,   0,   0,   0,   0,   0,   0,   0,   0,   0,   0,   0,   0,   0,   0,   0,   0,   0,   0,   0,   0,   0,   0,   0,   0,   0,   0,   0,   0,   0,   0,   0,   0,   0,   0,   0,   0, 
    0,   0,   0,   0,   0,   0, 237,  28,  36,   0,   0,   0,   0,   0,   0, 237,  28,  36,   0,   0,   0, 237,  28,  36, 237,  28,  36, 237,  28,  36, 237,  28,  36,   0,   0,   0, 237,  28,  36,   0,   0,   0,   0,   0,   0,   0,   0,   0,   0,   0,   0, 237,  28,  36,   0,   0,   0,   0,   0,   0,   0,   0,   0,   0,   0,   0,   0,   0,   0, 237,  28,  36, 237,  28,  36,   0,   0,   0,   0,   0,   0,   0,   0,   0,   0,   0,   0, 237,  28,  36,   0,   0,   0,   0,   0,   0,   0,   0,   0, 237,  28,  36,   0,   0,   0,   0,   0,   0, 237,  28,  36, 237,  28,  36,   0,   0,   0,   0,   0,   0, 237,  28,  36, 237,  28,  36, 237,  28,  36,   0,   0,   0,   0,   0,   0, 237,  28,  36,   0,   0,   0,   0,   0,   0,   0,   0,   0,   0,   0,   0, 237,  28,  36, 237,  28,  36, 237,  28,  36,   0,   0,   0,   0,   0,   0,   0,   0,   0, 237,  28,  36,   0,   0,   0,   0,   0,   0,   0,   0,   0,   0,   0,   0,   0,   0,   0,   0,   0,   0,   0,   0,   0, 
    0,   0,   0,   0,   0,   0, 237,  28,  36,   0,   0,   0,   0,   0,   0, 237,  28,  36,   0,   0,   0, 237,  28,  36,   0,   0,   0,   0,   0,   0,   0,   0,   0,   0,   0,   0, 237,  28,  36,   0,   0,   0,   0,   0,   0,   0,   0,   0,   0,   0,   0, 237,  28,  36,   0,   0,   0,   0,   0,   0,   0,   0,   0,   0,   0,   0, 237,  28,  36,   0,   0,   0,   0,   0,   0, 237,  28,  36,   0,   0,   0,   0,   0,   0,   0,   0,   0, 237,  28,  36,   0,   0,   0,   0,   0,   0,   0,   0,   0, 237,  28,  36,   0,   0,   0, 237,  28,  36,   0,   0,   0,   0,   0,   0, 237,  28,  36,   0,   0,   0, 237,  28,  36,   0,   0,   0,   0,   0,   0, 237,  28,  36,   0,   0,   0, 237,  28,  36,   0,   0,   0,   0,   0,   0,   0,   0,   0,   0,   0,   0, 237,  28,  36,   0,   0,   0,   0,   0,   0, 237,  28,  36,   0,   0,   0,   0,   0,   0, 237,  28,  36,   0,   0,   0,   0,   0,   0,   0,   0,   0,   0,   0,   0,   0,   0,   0,   0,   0,   0,   0,   0,   0, 
    0,   0,   0,   0,   0,   0, 237,  28,  36, 237,  28,  36, 237,  28,  36, 237,  28,  36,   0,   0,   0, 237,  28,  36, 237,  28,  36, 237,  28,  36,   0,   0,   0,   0,   0,   0, 237,  28,  36,   0,   0,   0,   0,   0,   0,   0,   0,   0,   0,   0,   0, 237,  28,  36,   0,   0,   0,   0,   0,   0,   0,   0,   0,   0,   0,   0, 237,  28,  36,   0,   0,   0,   0,   0,   0, 237,  28,  36,   0,   0,   0,   0,   0,   0,   0,   0,   0, 237,  28,  36,   0,   0,   0, 237,  28,  36,   0,   0,   0, 237,  28,  36,   0,   0,   0, 237,  28,  36,   0,   0,   0,   0,   0,   0, 237,  28,  36,   0,   0,   0, 237,  28,  36, 237,  28,  36, 237,  28,  36,   0,   0,   0,   0,   0,   0, 237,  28,  36,   0,   0,   0,   0,   0,   0,   0,   0,   0,   0,   0,   0, 237,  28,  36,   0,   0,   0,   0,   0,   0, 237,  28,  36,   0,   0,   0,   0,   0,   0, 237,  28,  36,   0,   0,   0,   0,   0,   0,   0,   0,   0,   0,   0,   0,   0,   0,   0,   0,   0,   0,   0,   0,   0, 
    0,   0,   0,   0,   0,   0, 237,  28,  36,   0,   0,   0,   0,   0,   0, 237,  28,  36,   0,   0,   0, 237,  28,  36,   0,   0,   0,   0,   0,   0,   0,   0,   0,   0,   0,   0, 237,  28,  36,   0,   0,   0,   0,   0,   0,   0,   0,   0,   0,   0,   0, 237,  28,  36,   0,   0,   0,   0,   0,   0,   0,   0,   0,   0,   0,   0, 237,  28,  36,   0,   0,   0,   0,   0,   0, 237,  28,  36,   0,   0,   0,   0,   0,   0,   0,   0,   0, 237,  28,  36, 237,  28,  36,   0,   0,   0, 237,  28,  36, 237,  28,  36,   0,   0,   0, 237,  28,  36,   0,   0,   0,   0,   0,   0, 237,  28,  36,   0,   0,   0, 237,  28,  36,   0,   0,   0, 237,  28,  36,   0,   0,   0,   0,   0,   0, 237,  28,  36,   0,   0,   0,   0,   0,   0,   0,   0,   0,   0,   0,   0, 237,  28,  36,   0,   0,   0,   0,   0,   0, 237,  28,  36,   0,   0,   0,   0,   0,   0,   0,   0,   0,   0,   0,   0,   0,   0,   0,   0,   0,   0,   0,   0,   0,   0,   0,   0,   0,   0,   0,   0,   0,   0, 
    0,   0,   0,   0,   0,   0, 237,  28,  36,   0,   0,   0,   0,   0,   0, 237,  28,  36,   0,   0,   0, 237,  28,  36, 237,  28,  36, 237,  28,  36, 237,  28,  36,   0,   0,   0, 237,  28,  36, 237,  28,  36, 237,  28,  36, 237,  28,  36,   0,   0,   0, 237,  28,  36, 237,  28,  36, 237,  28,  36, 237,  28,  36,   0,   0,   0,   0,   0,   0, 237,  28,  36, 237,  28,  36,   0,   0,   0,   0,   0,   0,   0,   0,   0,   0,   0,   0, 237,  28,  36,   0,   0,   0,   0,   0,   0,   0,   0,   0, 237,  28,  36,   0,   0,   0,   0,   0,   0, 237,  28,  36, 237,  28,  36,   0,   0,   0,   0,   0,   0, 237,  28,  36,   0,   0,   0,   0,   0,   0, 237,  28,  36,   0,   0,   0, 237,  28,  36, 237,  28,  36, 237,  28,  36, 237,  28,  36,   0,   0,   0, 237,  28,  36, 237,  28,  36, 237,  28,  36,   0,   0,   0,   0,   0,   0,   0,   0,   0, 237,  28,  36,   0,   0,   0,   0,   0,   0,   0,   0,   0,   0,   0,   0,   0,   0,   0,   0,   0,   0,   0,   0,   0, 
    0,   0,   0,   0,   0,   0,   0,   0,   0,   0,   0,   0,   0,   0,   0,   0,   0,   0,   0,   0,   0,   0,   0,   0,   0,   0,   0,   0,   0,   0,   0,   0,   0,   0,   0,   0,   0,   0,   0,   0,   0,   0,   0,   0,   0,   0,   0,   0,   0,   0,   0,   0,   0,   0,   0,   0,   0,   0,   0,   0,   0,   0,   0,   0,   0,   0,   0,   0,   0,   0,   0,   0,   0,   0,   0,   0,   0,   0,   0,   0,   0,   0,   0,   0,   0,   0,   0,   0,   0,   0,   0,   0,   0,   0,   0,   0,   0,   0,   0,   0,   0,   0,   0,   0,   0,   0,   0,   0,   0,   0,   0,   0,   0,   0,   0,   0,   0,   0,   0,   0,   0,   0,   0,   0,   0,   0,   0,   0,   0,   0,   0,   0,   0,   0,   0,   0,   0,   0,   0,   0,   0,   0,   0,   0,   0,   0,   0,   0,   0,   0,   0,   0,   0,   0,   0,   0,   0,   0,   0,   0,   0,   0,   0,   0,   0,   0,   0,   0,   0,   0,   0,   0,   0,   0,   0,   0,   0,   0,   0,   0,   0,   0,   0,   0,   0,   0,   0,   0,   0,   0,   0,   0,   0,   0,   0
};
